1111111111111111111111111111111111
100000000000000000E000000000000001
100P000000000000000000000000000001
1000000000000000000000000000000001
100000000000000000C000000000000001
100000000000000N000000000000000001
1000000000000000111111111111111111
1111111111111111111111111111111111
